10 13 13 13 13 13 13 13 13 13 13 13 13 13 00 00 00 00 00 00 00 00 13 13 13 13 13 13 13 13 13 13 13 13 13 13 13 13 13 13 13 13 13 13 13 13 13 13 13 13 13 13 13 13 13 13 13 13 13 13 13 13 13 13 13 00 00 00 00 00 13 13 13 13 13 13 13 13 00 
10 13 13 13 13 13 13 13 13 13 13 13 13 13 00 00 00 00 00 00 00 00 13 13 13 13 13 13 13 13 13 13 13 13 13 13 13 13 13 13 13 13 13 13 13 13 13 13 13 13 13 13 13 13 13 13 13 13 13 13 13 13 13 13 13 00 00 00 00 00 13 13 13 13 13 13 13 13 00 
10 40 40 40 40 40 40 40 40 40 40 40 40 40 00 00 00 00 00 00 00 10 40 40 40 40 40 40 40 40 40 40 40 40 40 40 40 40 40 40 40 40 40 40 40 40 40 40 40 40 40 40 40 40 40 40 40 40 40 40 40 40 40 40 40 00 00 00 00 10 40 40 40 40 40 40 40 40 00
10 40 40 40 40 40 40 40 40 40 40 40 40 40 00 00 00 00 00 00 00 10 40 40 40 40 40 40 40 40 40 40 40 40 40 40 40 40 40 40 40 40 40 40 40 40 40 40 40 40 40 40 40 40 40 40 40 40 40 40 40 40 40 40 40 00 00 00 00 10 40 40 40 40 40 40 40 40 00
10 40 40 40 40 40 40 40 40 40 40 40 40 40 00 00 00 00 00 00 00 10 40 40 40 40 40 40 40 40 40 40 40 40 40 40 40 40 40 40 40 40 40 40 00 00 00 00 00 00 00 00 00 00 00 00 00 00 00 00 00 10 40 40 40 00 00 00 00 10 40 40 40 40 40 40 40 40 00
10 40 40 40 40 40 40 40 40 40 40 40 40 40 00 00 00 00 00 00 00 10 40 40 40 40 40 40 40 40 40 40 40 40 40 40 40 40 40 40 40 40 40 40 00 00 00 00 00 00 00 00 00 00 00 00 00 00 00 00 00 10 40 40 40 00 00 00 00 10 40 40 40 40 40 40 40 40 00
10 40 40 40 40 40 40 40 40 40 40 40 40 40 00 00 00 00 00 00 00 10 40 40 40 40 00 00 00 00 00 00 00 00 00 00 10 40 40 40 40 40 40 40 00 00 00 00 00 00 00 00 00 00 00 00 00 00 00 00 00 10 40 40 40 00 00 00 00 10 40 40 40 40 40 40 40 40 00
00 00 00 00 00 00 00 00 00 00 10 40 40 40 00 00 00 00 00 00 00 10 40 40 40 40 00 00 00 00 00 00 00 00 00 00 10 40 40 40 40 40 40 40 00 00 00 00 00 00 00 00 00 00 00 00 00 00 00 00 00 10 40 40 40 00 00 00 00 10 40 40 40 40 40 40 40 40 00
00 00 00 00 00 00 00 00 00 00 10 40 40 40 00 00 00 00 00 00 00 10 40 40 40 40 00 00 00 00 00 00 00 00 00 00 10 40 40 40 40 40 40 40 00 00 00 00 00 00 00 00 00 00 00 00 00 00 00 00 00 10 40 40 40 00 00 00 00 10 40 40 40 40 40 40 40 40 00
00 00 00 00 00 00 00 00 00 00 10 40 40 40 00 00 00 00 00 00 00 10 40 40 40 40 00 00 00 00 00 00 00 00 00 00 10 40 40 40 40 40 40 40 00 00 00 00 00 00 00 00 00 00 00 00 00 00 00 00 00 10 40 40 40 00 00 00 00 10 40 40 40 40 40 40 40 40 00 00 00 00 00 00
00 00 00 00 00 00 00 00 00 00 10 40 40 40 00 00 00 00 00 00 00 10 40 40 40 40 00 00 00 00 00 00 00 00 00 00 10 40 40 40 40 40 40 40 00 00 00 00 00 00 00 00 00 00 00 00 00 00 00 00 00 10 40 40 40 40 40 40 40 40 40 40 40 40 40 40 40 40 40 40 40 40 40 10 
00 00 00 00 00 00 00 00 00 00 10 40 40 40 00 00 00 00 00 00 00 10 40 40 40 40 00 00 00 00 00 00 00 00 00 00 10 40 40 40 40 40 40 40 00 00 00 00 00 00 00 00 00 00 00 00 00 00 00 00 00 10 40 40 40 40 40 40 40 40 40 40 40 40 40 40 40 40 40 40 40 40 40 10 
00 00 00 00 00 00 00 00 00 00 10 40 40 40 00 00 00 00 00 00 00 10 40 40 40 40 00 00 00 00 00 00 00 00 00 00 10 40 40 40 40 40 40 40 00 00 00 00 00 00 00 00 00 00 00 00 00 00 00 00 00 10 40 40 40 40 40 40 40 40 40 40 40 40 40 40 40 40 40 40 40 40 40 10 
00 00 00 00 00 00 00 00 00 00 10 40 40 40 00 00 00 00 00 00 00 10 40 40 40 40 00 00 00 00 00 00 00 00 00 00 10 40 40 40 40 40 40 40 00 00 00 00 00 00 00 00 00 00 00 00 00 00 00 00 00 10 40 40 40 00 00 00 00 10 40 40 40 40 40 40 40 40 00 00 00 00 00 00
00 00 00 00 00 00 00 00 00 00 10 40 40 40 00 00 00 00 00 00 00 10 40 40 40 40 00 00 00 00 00 00 00 00 00 00 10 40 40 40 40 40 40 40 00 00 00 00 00 00 00 00 00 00 00 00 00 00 00 00 00 10 40 40 40 00 00 00 00 10 40 40 40 40 40 40 40 40 00
00 00 00 00 00 00 00 00 00 00 10 40 40 40 40 40 40 40 40 40 40 40 40 40 40 40 40 40 40 40 40 40 40 40 40 40 40 40 40 40 40 40 40 40 40 40 40 40 40 40 40 40 40 40 40 40 40 40 40 40 40 40 40 40 40 00 00 00 00 10 40 40 40 40 40 40 40 40 00
00 00 00 00 00 00 00 00 00 00 10 40 40 40 40 40 40 40 40 40 40 40 40 40 40 40 40 40 40 40 40 40 40 40 40 40 40 40 40 40 40 40 40 40 40 40 40 40 40 40 40 40 40 40 40 40 40 40 40 40 40 40 40 40 40 00 00 00 00 10 40 40 40 40 40 40 40 40 00
00 00 00 00 00 00 00 00 00 00 10 40 40 40 40 40 40 40 40 40 40 40 40 40 40 40 00 00 00 00 00 00 00 00 00 00 10 40 40 40 40 40 40 40 40 40 40 40 40 40 40 40 40 40 40 40 40 40 40 40 40 40 40 40 40 00 00 00 00 10 40 40 40 40 40 40 40 40 00
00 00 00 00 00 00 00 00 00 00 10 40 40 40 40 40 40 40 40 40 40 40 40 40 40 40 00 00 00 00 00 00 00 00 00 00 10 40 40 40 40 40 40 40 40 40 40 40 40 40 40 40 40 40 40 40 40 40 40 40 40 40 40 40 40 00 00 00 00 10 40 40 40 40 40 40 40 40 00
00 00 00 00 00 00 00 00 00 00 00 00 00 00 00 00 00 00 00 00 00 00 00 00 00 00 00 00 00 00 00 00 00 00 00 00 00 00 00 00 00 00 00 00 00 00 00 00 00 00 00 00 00 00 00 00 00 00 00 00 00 00 00 00 00 00 00 00 00 00 00 00 00 00 00 00 00 00 00