37 34 34 34 34 34 34 34 34 34 34 34 34 34 34 34 34 34 34 34 34 34 34 34 34 34 34 34 34 34 34 34 34 34 34 34 34 34 34 34 34 34 34 34 34 34 34 34 34 34 34 34 34 34 34 
37 34 34 34 34 34 34 34 34 34 34 34 34 34 34 34 34 34 34 34 34 34 34 34 34 34 34 34 34 34 34 34 34 34 34 34 34 34 34 34 34 34 34 34 34 34 34 34 34 34 34 34 34 34 34 
37 7 7 7 7 7 7 7 7 7 7 7 7 7 37 37 37 37 37 37 37 37 7 7 7 7 7 7 7 7 7 7 7 7 7 7 7 7 7 7 7 7 7 7 7 7 7 7 7 7 7 7 7 7 7 7 7 7 7 7 7 7 7 7 7 37
37 7 7 7 7 7 7 7 7 7 7 7 7 7 37 37 37 37 37 37 37 37 7 7 7 7 7 7 7 7 7 7 7 7 7 7 7 7 7 7 7 7 7 7 7 7 7 7 7 7 7 7 7 7 7 7 7 7 7 7 7 7 7 7 7 37
37 7 7 7 7 7 7 7 7 7 7 7 7 7 37 37 37 37 37 37 37 37 7 7 7 7 7 7 7 7 7 7 7 7 7 7 7 7 7 7 7 7 7 7 37 37 37 37 37 37 37 37 37 37 37 37 37 37 37 37 37 37 7 7 7 37
37 7 7 7 7 7 7 7 7 7 7 7 7 7 37 37 37 37 37 37 37 37 7 7 7 7 7 7 7 7 7 7 7 7 7 7 7 7 7 7 7 7 7 7 37 37 37 37 37 37 37 37 37 37 37 37 37 37 37 37 37 37 7 7 7 37
37 7 7 7 7 7 7 7 7 7 7 7 7 7 37 37 37 37 37 37 37 37 7 7 7 7 37 37 37 37 37 37 37 37 37 37 37 7 7 7 7 7 7 7 37 37 37 37 37 37 37 37 37 37 37 37 37 37 37 37 37 37 7 7 7 37
37 37 37 37 37 37 37 37 37 37 37 7 7 7 37 37 37 37 37 37 37 37 7 7 7 7 37 37 37 37 37 37 37 37 37 37 37 7 7 7 7 7 7 7 37 37 37 37 37 37 37 37 37 37 37 37 37 37 37 37 37 37 7 7 7 37
37 37 37 37 37 37 37 37 37 37 37 7 7 7 37 37 37 37 37 37 37 37 7 7 7 7 37 37 37 37 37 37 37 37 37 37 37 7 7 7 7 7 7 7 37 37 37 37 37 37 37 37 37 37 37 37 37 37 37 37 37 37 7 7 7 37
37 37 37 37 37 37 37 37 37 37 37 7 7 7 37 37 37 37 37 37 37 37 7 7 7 7 37 37 37 37 37 37 37 37 37 37 37 7 7 7 7 7 7 7 37 37 37 37 37 37 37 37 37 37 37 37 37 37 37 37 37 37 7 7 7 37 37 37 37 37 37 37 37 37 37 37
37 37 37 37 37 37 37 37 37 37 37 7 7 7 37 37 37 37 37 37 37 37 7 7 7 7 37 37 37 37 37 37 37 37 37 37 37 7 7 7 7 7 7 7 37 37 37 37 37 37 37 37 37 37 37 37 37 37 37 37 37 37 7 7 7 7 7 7 7 7 7 7 7 7 7 37
37 37 37 37 37 37 37 37 37 37 37 7 7 7 37 37 37 37 37 37 37 37 7 7 7 7 37 37 37 37 37 37 37 37 37 37 37 7 7 7 7 7 7 7 37 37 37 37 37 37 37 37 37 37 37 37 37 37 37 37 37 37 7 7 7 7 7 7 7 7 7 7 7 7 7 37
37 37 37 37 37 37 37 37 37 37 37 7 7 7 37 37 37 37 37 37 37 37 7 7 7 7 37 37 37 37 37 37 37 37 37 37 37 7 7 7 7 7 7 7 37 37 37 37 37 37 37 37 37 37 37 37 37 37 37 37 37 37 7 7 7 7 7 7 7 7 7 7 7 7 7 37
37 37 37 37 37 37 37 37 37 37 37 7 7 7 37 37 37 37 37 37 37 37 7 7 7 7 37 37 37 37 37 37 37 37 37 37 37 7 7 7 7 7 7 7 37 37 37 37 37 37 37 37 37 37 37 37 37 37 37 37 37 37 7 7 7 37 37 37 37 37 37 37 37 37 37 37
37 37 37 37 37 37 37 37 37 37 37 7 7 7 37 37 37 37 37 37 37 37 7 7 7 7 37 37 37 37 37 37 37 37 37 37 37 7 7 7 7 7 7 7 37 37 37 37 37 37 37 37 37 37 37 37 37 37 37 37 37 37 7 7 7 37
37 37 37 37 37 37 37 37 37 37 37 7 7 7 7 7 7 7 7 7 7 7 7 7 7 7 7 7 7 7 7 7 7 7 7 7 7 7 7 7 7 7 7 7 7 7 7 7 7 7 7 7 7 7 7 7 7 7 7 7 7 7 7 7 7 37
37 37 37 37 37 37 37 37 37 37 37 7 7 7 7 7 7 7 7 7 7 7 7 7 7 7 7 7 7 7 7 7 7 7 7 7 7 7 7 7 7 7 7 7 7 7 7 7 7 7 7 7 7 7 7 7 7 7 7 7 7 7 7 7 7 37
37 37 37 37 37 37 37 37 37 37 37 7 7 7 7 7 7 7 7 7 7 7 7 7 7 7 37 37 37 37 37 37 37 37 37 37 37 7 7 7 7 7 7 7 7 7 7 7 7 7 7 7 7 7 7 7 7 7 7 7 7 7 7 7 7 37
37 37 37 37 37 37 37 37 37 37 37 7 7 7 7 7 7 7 7 7 7 7 7 7 7 7 37 37 37 37 37 37 37 37 37 37 37 7 7 7 7 7 7 7 7 7 7 7 7 7 7 7 7 7 7 7 7 7 7 7 7 7 7 7 7 37
37 37 37 37 37 37 37 37 37 37 37 37 37 37 37 37 37 37 37 37 37 37 37 37 37 37 37 37 37 37 37 37 37 37 37 37 37 37 37 37 37 37 37 37 37 37 37 37 37 37 37 37 37 37 37 37 37 37 37 37 37 37 37 37 37 37